data_rppa_Zscores.txt	data_rppa_zscores.txt	meta_rppa_Zscores.txt	meta_rppa_zscores.txt
data_protein_quantification_Zscores.txt	data_protein_quantification_zscores.txt	meta_protein_quantification_Zscores.txt	meta_protein_quantification_zscores.txt
data_expression.txt	data_mrna_affymetrix_microarray.txt	meta_expression.txt	meta_mrna_microarray.txt
data_expression_Zscores.txt	data_mrna_affymetrix_microarray_zscores_ref_diploid_samples.txt	meta_expression_Zscores.txt	meta_mrna_microarray_zscores_ref_diploid_samples.txt
data_expression_all_sample_Zscores.txt	data_mrna_affymetrix_microarray_zscores_ref_all_samples.txt	meta_expression_all_sample_Zscores.txt	meta_mrna_microarray_zscores_ref_all_samples.txt
data_expression_median.txt	data_mrna_agilent_microarray.txt	meta_expression_median.txt	meta_mrna_agilent_microarray.txt
data_mRNA_median_Zscores.txt	data_mrna_agilent_microarray_zscores_ref_diploid_samples.txt	meta_mRNA_median_Zscores.txt	meta_mrna_agilent_microarray_zscores_ref_diploid_samples.txt
data_mRNA_median_all_sample_Zscores.txt	data_mrna_agilent_microarray_zscores_ref_all_samples.txt	meta_mRNA_median_all_sample_Zscores.txt	meta_mrna_agilent_microarray_zscores_ref_all_samples.txt
data_RNA_Seq_expression_median.txt	data_mrna_seq_rpkm.txt	meta_RNA_Seq_expression_median.txt	meta_mrna_seq_rpkm.txt
data_rna_seq_mrna.txt	data_mrna_seq_rpkm.txt	meta_rna_seq_mrna.txt	meta_mrna_seq_rpkm.txt
data_rna_seq_mrna_median_Zscores.txt	data_mrna_seq_rpkm_zscores_ref_diploid_samples.txt	meta_rna_seq_mrna_median_Zscores.txt	meta_mrna_seq_rpkm_zscores_ref_diploid_samples.txt
data_RNA_Seq_mRNA_median_Zscores.txt	data_mrna_seq_rpkm_zscores_ref_diploid_samples.txt	meta_RNA_Seq_mRNA_median_Zscores.txt	meta_mrna_seq_rpkm_zscores_ref_diploid_samples.txt
data_expression_zscores_file.txt	data_mrna_seq_rpkm_zscores_ref_diploid_samples.txt	meta_expression_zscores_file.txt	meta_mrna_seq_rpkm_zscores_ref_diploid_samples.txt
data_RNA_Seq_mRNA_median_all_sample_Zscores.txt	data_mrna_seq_rpkm_zscores_ref_all_samples.txt	meta_RNA_Seq_mRNA_median_all_sample_Zscores.txt	meta_mrna_seq_rpkm_zscores_ref_all_samples.txt
data_RNA_Seq_v2_expression_median.txt	data_mrna_seq_v2_rsem.txt	meta_RNA_Seq_v2_expression_median.txt	meta_mrna_seq_v2_rsem.txt
data_RNA_Seq_v2_expression_RSEM_UQ_Log2.txt	data_mrna_seq_v2_rsem.txt	meta_RNA_Seq_v2_expression_RSEM_UQ_Log2.txt	meta_mrna_seq_v2_rsem.txt
data_RNA_Seq_v2_mRNA_median_Zscores.txt	data_mrna_seq_v2_rsem_zscores_ref_diploid_samples.txt	meta_RNA_Seq_v2_mRNA_median_Zscores.txt	meta_mrna_seq_v2_rsem_zscores_ref_diploid_samples.txt
data_RNA_Seq_v2_mRNA_median_all_sample_Zscores.txt	data_mrna_seq_v2_rsem_zscores_ref_all_samples.txt	meta_RNA_Seq_v2_mRNA_median_all_sample_Zscores.txt	meta_mrna_seq_v2_rsem_zscores_ref_all_samples.txt
data_mRNA_seq_fpkm_capture.txt	data_mrna_seq_fpkm_capture.txt	meta_mRNA_seq_fpkm_capture.txt	meta_mrna_seq_fpkm_capture.txt
data_mRNA_seq_fpkm_capture_Zscores.txt	data_mrna_seq_fpkm_capture_zscores_ref_diploid_samples.txt	meta_mRNA_seq_fpkm_capture_Zscores.txt	meta_mrna_seq_fpkm_capture_zscores_ref_diploid_samples.txt
data_mRNA_seq_fpkm_capture_all_sample_Zscores.txt	data_mrna_seq_fpkm_capture_zscores_ref_all_samples.txt	meta_mRNA_seq_fpkm_capture_all_sample_Zscores.txt	meta_mrna_seq_fpkm_capture_zscores_ref_all_samples.txt
data_mRNA_seq_fpkm_polya.txt	data_mrna_seq_fpkm_polya.txt	meta_mRNA_seq_fpkm_polya.txt	meta_mrna_seq_fpkm_polya.txt
data_mRNA_seq_fpkm_polya_Zscores.txt	data_mrna_seq_fpkm_polya_zscores_ref_diploid_samples.txt	meta_mRNA_seq_fpkm_polya_Zscores.txt	meta_mrna_seq_fpkm_polya_zscores_ref_diploid_samples.txt
data_mRNA_seq_fpkm_polya_all_sample_Zscores.txt	data_mrna_seq_fpkm_polya_zscores_ref_all_samples.txt	meta_mRNA_seq_fpkm_polya_all_sample_Zscores.txt	meta_mrna_seq_fpkm_polya_zscores_ref_all_samples.txt
data_RNA_Seq_expression_cpm.txt	data_mrna_seq_cpm.txt	meta_RNA_Seq_expression_cpm.txt	meta_mrna_seq_cpm.txt
data_RNA_Seq_expression_cpm_Zscores.txt	data_mrna_seq_cpm_zscores_ref_diploid_samples.txt	meta_RNA_Seq_expression_cpm_Zscores.txt	meta_mrna_seq_cpm_zscores_ref_diploid_samples.txt
data_RNA_Seq_expression_cpm_all_sample_Zscores.txt	data_mrna_seq_cpm_zscores_ref_all_samples.txt	meta_RNA_Seq_expression_cpm_all_sample_Zscores.txt	meta_mrna_seq_cpm_zscores_ref_all_samples.txt
data_RNA_Seq_expression_tpm.txt	data_mrna_seq_tpm.txt	meta_RNA_Seq_expression_tpm.txt	meta_mrna_seq_tpm.txt
data_RNA_Seq_expression_tpm_Zscores.txt	data_mrna_seq_tpm_zscores_ref_diploid_samples.txt	meta_RNA_Seq_expression_tpm_Zscores.txt	meta_mrna_seq_tpm_zscores_ref_diploid_samples.txt
data_RNA_Seq_expression_tpm_all_sample_Zscores.txt	data_mrna_seq_tpm_zscores_ref_all_samples.txt	meta_RNA_Seq_expression_tpm_all_sample_Zscores.txt	meta_mrna_seq_tpm_zscores_ref_all_samples.txt
data_RNA_Seq_v2_mRNA_median_normals.txt	data_mrna_seq_v2_rsem_normal_samples.txt	meta_RNA_Seq_v2_mRNA_median_normals.txt	meta_mrna_seq_v2_rsem_normal_samples.txt
data_RNA_Seq_v2_mRNA_median_Zscores_normals.txt	data_mrna_seq_v2_rsem_normal_samples_zscores_ref_normal_samples.txt	meta_RNA_Seq_v2_mRNA_median_Zscores_normals.txt	meta_mrna_seq_v2_rsem_normal_samples_zscores_ref_normal_samples.txt
data_RNA_Seq_v2_mRNA_median_all_sample_ref_normal_Zscores.txt	data_mrna_seq_v2_rsem_zscores_ref_normal_samples.txt	meta_RNA_Seq_v2_mRNA_median_all_sample_ref_normal_Zscores.txt	meta_mrna_seq_v2_rsem_zscores_ref_normal_samples.txt
data_expression_merged.txt	data_mrna_affymetrix_microarray_merged.txt	meta_expression_merged.txt	meta_mrna_affymetrix_microarray_merged.txt
data_expression_merged_Zscores.txt	data_mrna_affymetrix_microarray_merged_zscores_ref_diploid_samples.txt	meta_expression_merged_Zscores.txt	meta_mrna_affymetrix_microarray_merged_zscores_ref_diploid_samples.txt
data_expression_merged_median_Zscores.txt	data_mrna_mirna_merged_zscores.txt	meta_expression_merged_median_Zscores.txt	meta_mrna_mirna_merged_zscores.txt
data_mRNA_outliers.txt	data_mrna_outliers.txt	meta_mRNA_outliers.txt	meta_mRNA_outliers.txt
data_expression_miRNA.txt	data_mirna.txt	meta_expression_miRNA.txt	meta_mirna.txt
data_miRNA_median_Zscores.txt	data_mirna_zscores.txt	meta_miRNA_median_Zscores.txt	meta_mirna_zscores.txt